%%%%%%%%%%%%%%%%%%%%
%                  %
%            GG    %
%            GG    %
%                  %
%                  %
%                  %
%                  %
%                  %
%                  %
%                  %
%                  %
%  P               %
%%%%%%%%%%%%%%%%%%%%
% % % % %%%%%%%%%%%%
%%%%%%%%%%%%%%%%%%%%