%%%%%%%%%%%%%%%%%%%%
%                  %
%               P  %
%                  %
%                  %
%                  %
%                  %
%                  %
%                  %
%                  %
%   GG             %
%   GG             %
%                  %
%%%%%%%%%%%%%%%%%%%%
% % % % %%%%%%%%%%%%
%%%%%%%%%%%%%%%%%%%%