%%%%%%%%%%%%%%%%%%%%
%                  %
%   P              %
%                  %
%                  %
%                  %
%                  %
%                  %
%                  %
%                  %
%             GG   %
%             GG   %
%                  %
%%%%%%%%%%%%%%%%%%%%
% % % % %%%%%%%%%%%%
%%%%%%%%%%%%%%%%%%%%